#######################################################
#..222222222222.....22222222222.....2222222222222222..#
#..222222222222.....22222222222.....2222222222222222..#
#..222222222222.....22222222222.....2222222222222222..#
#..222222222222.....22222222222.....2222222222222222..#
#..222222222222.....22222222222.....2222222222222222..#
#.....................................................#
###########..#...........................#.....##.....#
#.....................................................#
#.....................................................#
#..1111111111111111111111111111111111111111111111111..#
#.........#.....#.........................#...........#
#.........#.....#..................#......#...........#
#..1111111111111111111111111111111111111111111111111..#
#..1111111111111111111111111111111111111111111111111..#
#..1111111111111111111111111111111111111111111111111..#
#######################################################